11111111111111111111111111
1E000000000000000C000000C1
10001000100010000001000101
10001000100010000001000101
10001000100010000001000101
10001000100010000001000101
10001000100010000001000101
10001000100010000001000101
10001000100010000001000101
10001000100010000001000101
1P0000000000000C0000C00001
11111111111111111111111111
